11..11211
#1..1#2#1
11..11211
111....11
1#1....1#
111..1121
.111.1#21
.1#21223#
.12#11#21