##########
#01234567#
##2#####8#
##3456789#
##########