#7########
#6##EF####
45##DE#123
####CD#0##
#89AB#####