.1#1.1#1....1#1.
.1111221..11211.
....1#11222#2221
....1112##213##1
......13#31.2#31
1221..1#21..111.
2##1..111111111.
3#41.....1#12#2.
2#311....1123#31
223#31.....2#5#1
#23##2111..2##32
12#5#33#311134#1
.12#22##3#211#21
.122112222#2332.
.1#1.....112##1.
.111.......1221.