#.#########
#.#.#T#...#
#.#.#.###.#
#.#.#.....#
#.#.#####.#
#.#.#.#.#.#
#.#.#.#.#.#
#.#.#.#...#
#.#.#.###.#
#........X#
#########.#
