#.###################################
#.#.#...#.#...#.#.#.#T#.#.#.#.#.#...#
#.#.###.#.###.#.#.#.#.#.#.#.#.#.###.#
#.........#.......#.#.#.#.#.#.#.#.#.#
#########.#######.#.#.#.#.#.#.#.#.#.#
#.#.........#.#.....#.......#.#...#.#
#.#########.#.#####.#######.#.###.#.#
#.#.#.#.#.#.#.........#.......#.#.#.#
#.#.#.#.#.#.#########.#######.#.#.#.#
#.....#.....#...#.....#...#.#.#.....#
#####.#####.###.#####.###.#.#.#####.#
#.#.......#...#.......#.#.........#.#
#.#######.###.#######.#.#########.#.#
#.#.#...#.......#.#.#.#...#...#.#...#
#.#.###.#######.#.#.#.###.###.#.###.#
#.....#.........#.....#.#.....#...#.#
#####.#########.#####.#.#####.###.#.#
#...#.#.#...#.#.....#.#.......#.....#
###.#.#.###.#.#####.#.#######.#####.#
#.#...#.#.#.....#.#.#...#.#...#...#.#
#.###.#.#.#####.#.#.###.#.###.###.#.#
#.#...#.#...#.#.....#.......#.#...#.#
#.###.#.###.#.#####.#######.#.###.#.#
#..................................X#
###################################.#
