#.#####
#.#.#T#
#.#.#.#
#....X#
#####.#
