#.###########
#...#T..#...#
###.###.###.#
#...#.#.....#
###.#.#####.#
#.#.#.#.#.#.#
#.#.#.#.#.#.#
#...#...#...#
###.###.###.#
#.......#.#.#
#######.#.#.#
#.....#.#...#
#####.#.###.#
#...#.#.#.#.#
###.#.#.#.#.#
#..........X#
###########.#
#.#...#.....#
#.###.#####.#
#...........#
###########.#
