10 5
#.########
#.##..####
..##..#...
####..#S##
#....#####