19 12
2 4
2
###################
#.................#
#..>>>v......>T...#
#..^..>v.....^<...#
#..^...>v.........#
#..^....v....>v...#
#..^....v....^v...#
#..^...v<....^v...#
#..^..v<.....^v...#
#..^<<<......^<...#
#.................#
###################
###################
#.................#
#...>>>v......>T..#
#...^..>v.....^<..#
#...^...>v........#
#...^....v....>v..#
#...^....v....^v..#
#...^...v<....^v..#
#...^..v<.....^v..#
#...^<<<......^<..#
#.................#
###################