19 7
....#...#..........
....#####..........
....#...#..........
....#.#.#..........
......#............
...S#####..........
....#...#..........