27 13
###########.###.###.###.###
#.........#..............S#
###########.....#########.#
.....#...#.......#...#.....
####...#...#.......#...####
#....#...###....#######...#
#.#######..#............#.#
#...#........############.#
#....#.#####....#.........#
#.....#......##...##.###.#.
.....#.#.....#.###.###.###.
..................#.......#
###.###.###.###.###.###.###