19 10
##..##.....########
##..###..#.#####...
#..################
.##.###############
.#..#####....######
#.#.##.#.#.##.#####
#####.#..0##..####.
####..############.
#..###############.
...########.######.
8
0 12 6 CAR
1 1 1 U
2 9 3 RL
3 14 3 UD
4 8 4 UDRL
5 4 6 U
6 7 7 R
7 17 7 U
