19 10
.#.########.##.##.#
###.##.###..#######
#..##.######.#.####
#...###..##...#.##.
#.######.#.#.#####.
.#####.############
##.####.#####..#.#.
#..#.##.#.0#....#..
.####.###.####..###
#####..#######.####
6
0 16 6 CAR
1 17 1 RL
2 5 3 UDRL
3 17 5 R
4 2 8 UDRL
5 13 8 RL
