19 10
###############..##
###############.###
#.0#..#############
####..#####.#######
#########....#####.
#..#########.####..
#...#####...######.
#.#..###..##..###..
####..##.#...######
########..#########
9
0 4 2 CAR
1 4 0 U
2 5 1 UDRL
3 0 2 UD
4 13 2 U
5 4 4 L
6 5 5 RL
7 0 6 U
8 15 7 UDRL
