19 10
##..#######.##.####
.#.....##...####.#.
..####..#.###..###.
#.#...###.###.##..#
##.#.########.####.
###.##.#.##########
.###.#######.######
##.####.###.#####..
#####.0###.##.###.#
#.###.#.####.#....#
8
0 18 7 CAR
1 16 4 R
2 5 5 RL
3 9 5 U
4 14 5 R
5 18 6 R
6 8 8 UDRL
7 9 9 UD
