19 10
#####..##########..
##########..#####.#
##...#############.
###.....###########
###....###.###...##
######..#####..#.##
#########..0...#..#
##########.#.##.#.#
#..###########...##
#...###############
10
0 17 0 CAR
1 3 1 UDRL
2 4 1 R
3 9 2 D
4 10 2 UD
5 17 3 RL
6 13 4 RL
7 8 6 UD
8 13 7 UDRL
9 5 9 UDRL
