19 10
###################
#.##############.##
###################
#####.#############
#############.#####
#########0...######
####.##############
###############.###
###################
###################
2
0 1 1 CAR
1 2 1 UDRL
