19 10
##..##.#########.##
###....######....##
##..#..######.#.###
#############..###0
#.#########..#..###
....#..#####.#...##
#.#..##..###.######
#.#.####..#.#######
#.#.#.##########..#
##########.######..
10
0 13 2 CAR
1 1 1 UDRL
2 0 2 UDRL
3 18 2 D
4 0 3 RL
5 5 4 L
6 6 6 D
7 18 6 U
8 13 7 UDRL
9 14 7 UD
