19 10
.##########..###.0#
.#..######.######.#
#..#######..##...##
...#########...####
..##..#####.#..####
#.#####.##...###..#
############.#.####
....#############..
##.##....##########
####.....##########
10
0 0 3 CAR
1 5 1 UD
2 14 1 UD
3 16 1 RL
4 6 2 D
5 6 3 UD
6 11 6 UDRL
7 5 7 L
8 10 7 L
9 9 9 L
