19 10
.#.....#########...
0.##############.##
#..########.#######
##########..#######
##.###.########..#.
###############..#.
####.######.#####..
####.###....####...
.#.#..#.##.##.##.##
...#.##.#..#####..#
9
0 10 9 CAR
1 8 2 RL
2 12 3 UDRL
3 13 3 D
4 17 3 U
5 2 5 D
6 11 5 RL
7 0 7 RL
8 5 7 UD
