19 10
#.#################
#.####.####....####
#.####.#.#.#....###
######...#..#.#####
##########.########
###############.#.#
##...######..##...#
##.0.##.####.#..#.#
#######..########.#
#######..########.#
10
0 12 2 CAR
1 3 1 UDRL
2 4 1 R
3 15 4 U
4 10 5 R
5 5 7 U
6 6 7 UD
7 10 7 UD
8 5 8 R
9 6 8 U
