19 10
##########.###...#.
##...##.0#.###.###.
##..###...#####..#.
##############....#
#######.##...######
######......####...
.#####...#.#.###...
.#######.###.######
.##################
#######...##...####
10
0 16 6 CAR
1 7 0 U
2 17 0 RL
3 6 1 RL
4 16 1 R
5 2 5 UD
6 12 5 UDRL
7 14 5 RL
8 14 8 RL
9 15 9 D
