19 10
###..#####....#####
###.#######..######
###....###..#######
##########.##..####
###########.#.#####
..######..#..######
.#######0.#.#.####.
..#######.##.#.##..
###.#..##.##..###..
###.##.#####.###..#
10
0 13 8 CAR
1 8 1 D
2 18 1 RL
3 7 2 RL
4 2 3 RL
5 7 3 R
6 17 3 UDRL
7 15 4 L
8 4 6 UDRL
9 16 8 RL
