19 10
#####..###.########
#####0.###.########
###################
..#########..##.#..
##.######.#..##...#
.####.###..#.###.#.
.####.##.#.######..
...##...###....##.#
##.##.####..#..####
.#.##.#############
10
0 6 7 CAR
1 1 0 UDRL
2 3 0 R
3 1 1 U
4 14 1 U
5 18 1 D
6 1 2 L
7 18 2 L
8 5 4 RL
9 2 6 D
