19 10
###################
###..#############.
###..#############.
###..#############.
###..#############.
###..#############.
###..#############.
###..######.0.####.
###################
###################
3
0 4 3 CAR
1 12 3 D
2 15 6 RL
