19 10
##.######...#.#..##
##..#####..#...##.#
##########.#..#.#.#
#####.###.#.####..#
#####..##.#.#.##.0#
#############.#..##
###################
###.########....###
##..#######.##.#.##
##########..#.#.###
10
0 13 4 CAR
1 6 0 UD
2 9 2 UD
3 8 3 RL
4 15 4 R
5 7 5 UD
6 4 6 UD
7 8 6 UDRL
8 2 9 U
9 18 9 R
