19 10
...................
.#################.
.#################.
.#################.
.########0########.
.#################.
.#################.
.#################.
.#################.
...................
5
0 0 0 CAR
1 1 1 UDRL
2 17 1 UDRL
3 1 8 UDRL
4 17 8 UDRL
