19 10
###################
#################..
##....##########0..
##..#.#.###...#####
###.#####.##.#.....
##..#####.#######.#
###########.#..####
.##.###.....#...###
......###..########
###.####..#########
8
0 15 4 CAR
1 10 0 R
2 0 1 R
3 7 1 D
4 13 1 RL
5 1 3 D
6 11 4 U
7 5 5 UDRL
