19 10
#############.#...#
########.########.#
#..#########...#..#
#..###########.####
#.#####..###..#####
##.####.##.#0######
############..#####
#######..#######..#
##.#....##########.
###.......##.###...
10
0 6 9 CAR
1 8 3 UD
2 11 3 R
3 17 3 RL
4 17 4 UD
5 0 5 L
6 14 5 UDRL
7 0 6 L
8 14 6 L
9 14 9 U
