19 10
###################
###..######...#####
###..######...#####
###..######...#####
###..######..0#####
###..######...#####
###..######...#####
###..######...#####
###################
###################
2
0 4 3 CAR
1 5 3 R
