19 10
#..########.##.##.#
#..##..###..####.#.
#..##..#########..#
##.#####.####.###..
######....###...###
#######...####...##
##############0####
#####....##...#####
#####.##.##.#..####
#####.######.######
9
0 5 9 CAR
1 13 1 UD
2 7 3 RL
3 12 3 RL
4 1 6 R
5 17 7 L
6 15 9 UD
7 16 9 L
8 17 9 UDRL
