19 10
####...############
..###########......
#.###########.#....
.#..##...##########
#.####...##########
.##.##..########...
0#.####...######.#.
..######.##########
######.######..####
#############..####
9
0 18 6 CAR
1 15 4 U
2 16 4 R
3 8 5 L
4 15 5 R
5 12 7 L
6 4 8 UDRL
7 0 9 U
8 11 9 R
