19 10
##...########.#####
##...#######...###.
######....##.#.###.
#########.###..####
#########.#..##.###
##.....###.#.#..###
####...###..##.####
#.###########.#####
#.0#####...##...###
#########..##..####
10
0 12 1 CAR
1 13 2 R
2 4 4 UDRL
3 16 4 U
4 18 6 R
5 4 7 L
6 9 7 U
7 0 8 D
8 1 9 UD
9 11 9 UDRL
