9 9
1 2 3 4 5 6 7 8 9
999 999 999 999 999 999 999 999 10
31 32 33 34 35 36 37 999 11
30 999 999 999 999 999 38 999 12
29 999 47 48 49 999 39 999 13
28 999 46 999 999 999 40 999 14
27 999 45 44 43 42 41 999 15
26 999 999 999 999 999 999 999 16
25 24 23 22 21 20 19 18 17
