19 10
#.########..##0..##
###########.###.###
########....##...##
...###..##.########
..#####..#..#######
###.###...#..######
##########.#####.##
######...##..##..##
####..###.#.##...##
#########..########
10
0 3 5 CAR
1 3 2 UDRL
2 16 4 UDRL
3 16 5 R
4 7 6 R
5 13 6 L
6 15 6 RL
7 6 8 R
8 7 8 RL
9 12 8 UD
