19 10
###################
#########.#########
###......#......###
###################
###################
###################
###################
###......#......###
#########0#########
###################
9
0 9 1 CAR
1 3 3 RL
2 15 3 RL
3 3 4 UDRL
4 15 4 RL
5 3 5 RL
6 15 5 RL
7 3 6 RL
8 15 6 RL
