19 10
...................
.#################.
.#################.
.#################.
.########0########.
.#################.
.#################.
.#################.
.#################.
...................
3
0 0 0 CAR
1 1 1 UDRL
2 17 1 UDRL
