19 10
#########.####..###
##...####...#####..
...####.....####.#.
..##.###########...
###################
######.###.####....
#...#..###.#####.##
####..####0####..#.
#..###.########.#..
######.############
9
0 9 1 CAR
1 4 2 UDRL
2 10 3 RL
3 5 4 U
4 17 4 L
5 2 5 UD
6 11 8 L
7 14 9 UD
8 16 9 R
