19 10
#.###.#############
#####.#..##########
####0....##########
##################.
..##..#####.#####..
..........#.#####..
..#.###############
#.########.####..##
###.######.####..##
.##################
9
0 17 5 CAR
1 12 0 U
2 10 1 R
3 13 1 UDRL
4 14 2 RL
5 10 4 U
6 2 7 UDRL
7 14 8 RL
8 11 9 UD
