19 10
###################
#...######.####0.##
#..###...#...##.##.
#...##.####..#####.
#######..#.#.####..
######..########..#
########.######..#.
#...#####.#####..##
#.#.##..#.....#.#.#
########..##.####.#
8
0 12 4 CAR
1 5 0 UD
2 5 4 UD
3 0 5 UDRL
4 1 5 UD
5 2 5 U
6 1 9 UDRL
7 5 9 UDRL
