19 10
######.#....###....
######...##.#####.#
##...#.....######..
##..#######.#####.#
###..##############
##.#..###.0########
##....######.######
########.###.###..#
#########.##.###.##
#########.######.##
10
0 3 4 CAR
1 12 0 L
2 1 1 R
3 10 1 L
4 15 2 UD
5 7 3 RL
6 8 3 R
7 18 6 UDRL
8 13 7 R
9 17 8 L
