6 6
1 1 2 2 3 3
1 1 2 2 3 3
6 6 5 5 4 4
6 6 5 5 4 4
7 7 8 8 9 9
7 7 8 8 9 9
