7 7 3
..####.
.##..#.
##.*.##
#..*..#
#.#*..#
#.....#
#######
3 5
2 3
3 3
4 3
