1 2
######~~~
..##==~~~
#.##=#~~~
####=####
..#==#+..
#.#######
####=##.#
..+#=#..#
####=####
