9 8 4
.####....
##..#....
#...#####
#.****..#
#.......#
###..####
..#..#...
..####...
4 6
2 4
3 4
4 4
5 4
