15 30 21
2 25
???????????????????????...##??
???????????????????????#####??
???????????????????????..T##??
???????????????????????####.??
???????????????????????####.??
??????????????????????????????
??????????????????????????????
??????????????????????????????
??????????????????????????????
??????????????????????????????
??????????????????????????????
??????????????????????????????
??????????????????????????????
??????????????????????????????
??????????????????????????????
