10 7 4
##########
#....#...#
#.#.**...#
#...**...#
###..#####
..#..#....
..####....
6 3
5 2
3 3
5 3
3 4
