8 7 3
.#####..
.#...##.
.#.#.*##
##..*..#
#..*...#
#...####
#####...
1 4
2 3
2 4
4 4
