10 10 5
#########.
#.......#.
#.#####.#.
#.#...#.##
#.#.#.#..#
#.#*.**..#
#.*......#
####.*.###
...#..##..
...####...
4 8
5 5
2 6
5 6
4 7
5 7
