9 7 4
#######..
#..#..#..
#..*..##.
#**#...##
#..*....#
#..##...#
#########
2 3
3 2
4 3
5 3
3 4
