8 8 4
####....
#..#....
#..#####
#......#
##.*.*.#
#..*#.##
#*....#.
#######.
4 6
3 3
2 4
3 4
5 4
