8 7 3
.#####..
.#...###
##.#...#
#..*.*.#
#..*#.##
##....#.
.######.
1 3
2 3
2 4
3 4
