15 30 70
3 6
??????????????????????????????
????.....?????????????????????
????#####?????????????????????
????..T..?????????????????????
????..#..?????????????????????
????#####?????????????????????
??????????????????????????????
??????????????????????????????
??????????????????????????????
??????????????????????????????
??????????????????????????????
??????????????????????????????
??????????????????????????????
??????????????????????????????
??????????????????????????????
