9 9 5
..####...
..#..#...
.##..#...
##..*#...
#.*.*##..
#.#.*.###
#.*.....#
####....#
...######
1 5
2 4
4 4
3 5
4 5
2 6
