15 30 71
11 22
??????????????????????????????
??????????????????????????????
??????????????????????????????
??????????????????????????????
??????????????????????????????
??????????????????????????????
??????????????????????????????
??????????????????????????????
??????????????????????????????
????????????????????#####?????
????????????????????..#..?????
????????????????????..T..?????
????????????????????#####?????
????????????????????.....?????
??????????????????????????????
