8 9 5
..####..
###..#..
#..*.##.
#.#...##
#..*#..#
##***..#
.#.....#
.#..####
.####...
5 3
2 4
5 4
3 5
4 5
3 6
