11 9 5
..####.....
..#..###...
###.**.####
#..*.#....#
#..*......#
###*.######
..#..#.....
..#..#.....
..####.....
4 6
4 2
7 3
3 4
6 4
3 5
