11 11 5
..####.....
..#..#.....
..#.*######
..#*.##...#
..#.......#
###*..*#.##
#..*#.##.#.
#.#...#..#.
#.#####.##.
#.......#..
#########..
3 1
3 2
4 3
4 4
8 4
5 6
