9 9 5
..#####..
.##...#..
##....#..
#.*.*####
#..*....#
###..**.#
..##..###
...#..#..
...####..
5 4
4 3
3 4
4 4
6 4
4 6
