2 0
####.#~~~
#....#~~~
#.####~~~
#######=#
#=======#
#=#######
#+#####.#
#.#+..#..
#.#######
