2 2
~~~#.####
~~~#....#
~~~####.#
#######.#
#==+....#
#=#######
#=#######
#=====+..
#########
