8 9 4
..####..
..#..#..
###..#..
#.**.###
#...**.#
##.....#
.##..###
..#..#..
..####..
4 2
3 3
4 3
3 4
4 6
