15 30 68
2 27
?????????????????????????#####
?????????????????????????#####
?????????????????????????..T##
?????????????????????????#####
?????????????????????????#####
??????????????????????????????
??????????????????????????????
??????????????????????????????
??????????????????????????????
??????????????????????????????
??????????????????????????????
??????????????????????????????
??????????????????????????????
??????????????????????????????
??????????????????????????????
