9 9 5
####.....
#..#.####
#..###..#
#..#....#
##..***.#
#......##
#..#**##.
#..#..#..
#######..
6 5
5 4
6 4
2 5
4 5
5 5
