9 9 4
.####....
.#..#....
.#..#####
##..#...#
#....*..#
#.#.*.###
#..**.#..
####..#..
...####..
5 3
2 4
4 4
5 4
3 5
