8 9 4
..####..
..#..#..
.##..#..
##.*.###
#..*.*.#
#..*...#
##.#.###
.#...#..
.#####..
4 6
2 4
4 4
3 5
5 5
