0 1
####.##.#
==##.##..
#=##+####
#=#~~~###
#==~~~+..
###~~~###
#.#######
#..===..#
#######.#
