9 9 5
.#######.
.#.....##
.#..#...#
##..*.#.#
#..#..*.#
#..**#.##
###.*..#.
..#..###.
..####...
5 1
5 2
3 3
2 4
6 5
3 6
