8 8 4
.#####..
##...###
#..**..#
#.#*.#.#
#...*..#
###..###
..#..#..
..####..
3 6
4 3
4 4
3 5
4 5
