9 10 5
.#####...
##...##..
#.....##.
#.#.#..##
#....#*.#
##***...#
.#..##*.#
.#...#.##
.###...#.
...#####.
4 4
4 2
3 3
3 4
3 5
5 5
