9 8 4
..#####..
.##...#..
##..#.#..
#.*.*.###
#.#.....#
#..**...#
##..#####
.####....
3 6
3 3
4 3
3 5
4 5
