10 10
0 9
0110001110
0001010000
1100000111
0001010001
0110001110
0000100000
0010001010
0101010100
1000100001
0000000000
0 0
