5 10 10
186
243
253
698
759
48 128 654 570 374 564 725 419 946 37
322 186 926 628 200 131 599 469 15 675
14 156 220 233 894 651 596 525 38 241
561 167 869 812 865 371 895 190 557 991
934 111 858 984 546 374 379 97 910 287
857 35 383 310 206 731 136 877 800 765
348 36 444 270 859 207 265 170 662 333
119 420 152 674 994 23 179 325 336 47
475 300 340 124 974 343 341 201 698 698
181 890 521 140 680 659 96 627 698 186
