10 10
5 4
0000000000
0111111110
0100000010
0101111010
0101001010
0101011010
0101011010
0101000010
0101111110
0100000000
0 9
