8
4,5,6,5,3,5,5,3
1,3,2,3,0,0,4,2
3,3,1,4,2,2,2,0
3
0,0,1,0,0,3,0,0 2,3,5,0,2,4,4,0
1,3,1,2,1,0,2,0 3,3,3,4,1,2,4,2
2,3,0,2,0,0,0,0 2,4,3,4,2,2,4,2
