21 21
20 19
111111111111111111111
000100000000010000000
011101111111010111110
000000000001000101000
011111110101111101011
000001010101000000010
110111011101011111110
000100010001010000000
111101110111010101111
000001000101010100000
011111011101011111110
000100010001010001000
110111010101010101010
010000010101000100010
011111110101111111110
010000000100010000010
010111011111110111110
010100000100010100010
010101111101010101010
000100000001000001000
111111111111111111111
0 1
