11 11
5 5
###########
#.....#...#
#.###.###.#
#...#.....#
#.#.#######
#.#...#...#
#####.###.#
....#.....#
#.#########
#..........
###########