5 10 10
6234
8814
5446
901
6264
689 627 87 640 100 545 551 467 981 931
368 279 386 481 20 460 661 863 881 808
635 655 429 380 867 453 832 418 274 635
179 929 917 211 76 489 899 667 289 346
454 426 520 305 703 131 685 23 957 681
964 44 756 552 713 681 618 208 916 979
138 45 343 531 100 717 334 347 478 968
726 129 918 271 22 605 656 598 958 139
834 617 414 471 933 220 787 706 628 506
130 371 692 290 123 451 49 539 920 347
