4
5,5,5,5
2,3,4,4
2,0,1,2
6
1,3,4,4 1,3,4,4
2,0,4,4 2,2,4,4
2,3,2,3 2,3,4,3
1,3,3,4 2,3,3,4
2,4,3,4 2,4,4,4
3,3,4,4 3,3,4,4
