5 10 10
843
971
8
275
908
337 762 240 948 346 25 107 125 472 607
693 13 688 388 988 134 431 770 911 7
864 362 74 21 322 926 692 45 537 655
350 883 57 799 881 626 518 19 563 288
937 436 93 167 988 882 925 935 157 167
704 576 654 385 434 231 466 515 677 144
919 377 440 344 728 702 907 132 711 423
326 112 634 616 137 355 699 81 440 215
204 848 488 270 741 358 237 384 817 354
141 717 502 185 562 378 696 13 18 716
